           ########
           #   ...#
############   ...#
#    #    $    ...#
# $$ #$  $ #   ...#
#          #   ...#
# $$ #$ $ $########
#  $ #     #
## #########
#    #    #
#         ##
#  $$#$$  @#
#    #    ##
###########
